{"tiles":[
[0,0,0,0,0,0,0,0,0,0,0,0,0,0,0,0,0,0,0,0],
[0,1,0,0,0,0,0,0,0,0,0,0,0,0,0,0,0,0,0,0],
[0,0,0,0,0,0,0,0,0,0,0,0,0,0,0,0,0,0,0,0],
[0,0,0,0,0,0,0,0,0,0,0,0,0,0,0,0,0,0,0,0],
[0,0,0,0,0,0,0,0,0,0,0,0,0,0,0,0,0,0,0,0],
[0,0,0,0,0,0,0,0,0,0,0,0,0,0,0,0,0,0,0,0],
[0,0,0,0,0,0,0,0,0,0,0,0,0,0,0,0,0,0,0,0],
[0,0,0,0,0,0,0,0,0,0,0,0,0,0,0,0,0,0,0,0],
[0,0,0,0,0,0,0,0,0,0,0,0,0,0,0,0,0,0,0,0],
[0,0,0,0,0,0,0,0,0,0,0,0,0,0,0,0,0,0,0,0],
[0,0,0,0,0,0,0,0,0,0,0,0,0,0,0,0,0,0,0,0],
[0,0,0,0,0,0,0,0,0,0,0,0,0,0,0,0,0,0,0,0],
[0,0,0,0,0,0,0,0,0,0,0,0,0,0,0,0,0,0,0,0],
[0,0,0,0,0,0,0,0,0,0,0,0,0,0,0,0,0,0,0,0],
[0,0,0,0,0,0,0,0,0,0,0,0,0,0,0,0,0,0,0,0]],

"mask":[
[0,1,0,0,0,0,0,0,1,0,0,0,1,0,0,0,0,0,0,0],
[0,0,1,1,0,0,0,1,1,0,1,0,0,0,1,0,0,1,0,1],
[1,0,0,0,1,0,0,0,0,0,0,0,0,0,0,0,0,1,1,1],
[0,0,0,0,1,0,0,0,0,0,1,0,1,1,0,1,0,0,0,0],
[1,0,0,0,0,0,1,0,0,0,0,0,1,0,0,0,0,0,1,0],
[0,1,1,0,1,0,0,0,0,1,1,1,1,0,0,1,1,0,0,0],
[0,1,0,0,1,0,0,0,0,1,0,0,0,0,0,1,0,1,0,0],
[0,0,0,0,1,0,0,0,0,0,0,0,0,1,0,0,0,0,1,1],
[0,0,1,1,1,0,0,0,0,1,0,0,1,0,0,0,1,0,0,0],
[1,0,1,1,0,0,1,0,1,0,0,0,0,0,0,0,0,0,0,0],
[0,0,0,0,0,0,1,0,0,1,0,0,0,0,0,1,0,0,0,1],
[0,1,0,1,0,0,1,0,0,0,0,0,0,1,0,0,0,0,0,0],
[0,0,0,0,0,0,0,0,0,0,0,1,0,0,0,0,0,1,0,0],
[0,1,1,0,1,0,1,0,0,0,1,0,0,0,1,1,0,0,0,1],
[0,0,0,0,0,0,0,1,1,0,0,0,0,0,1,0,0,1,0,0]],
"start":{"x":0,"y":0},"finish":{"x":0,"y":0}}